S . # . . . .
. . # . # # .
# . # . . . .
. . . . # . .
. # # . # . #
. . . . . . E
